가평 간판업체	가평 간판	가평 간판	간판
가평군 간판업체	가평 간판	가평 간판	간판업체
경기광주 간판업체	경기광주 간판	경기광주 간판	간판
강릉시 간판업체	강릉 간판	강릉 간판	간판업체
경기도광주 간판업체	경기광주 간판	경기광주 간판	간판
경기광주시 간판업체	경기광주 간판	경기광주 간판	간판업체
고양 간판업체	고양 간판	고양 간판	간판
경기도광주시 간판업체	경기광주 간판	경기광주 간판	간판업체
과천 간판업체	과천 간판	과천 간판	간판
고양시 간판업체	고양시 간판	고양시 간판	간판업체
광명 간판업체	광명 간판	광명 간판	간판
과천시 간판업체	과천 간판	과천 간판	간판업체
구리 간판업체	구리 간판	구리 간판	간판
광명시 간판업체	광명 간판	광명 간판	간판업체
김포 간판업체	김포 간판	김포 간판	간판
구리시 간판업체	구리 간판	구리 간판	간판업체
남양주 간판업체	남양주 간판	남양주 간판	간판
김포시 간판업체	김포 간판	김포 간판	간판업체
동두천 간판업체	동두천 간판	동두천 간판	간판
남양주시 간판업체	남양주 간판	남양주 간판	간판업체
부천 간판업체	부천 간판	부천 간판	간판
동두천시 간판업체	동두천 간판	동두천 간판	간판업체
서울 간판업체	서울 간판	서울 간판	간판
부천시 간판업체	부천 간판	부천 간판	간판업체
성남 간판업체	성남 간판	성남 간판	간판
성남시 간판업체	성남 간판	성남 간판	간판업체
수원 간판업체	수원 간판	수원 간판	간판
수원시 간판업체	수원 간판	수원 간판	간판업체
시흥 간판업체	시흥 간판	시흥 간판	간판
시흥시 간판업체	시흥 간판	시흥 간판	간판업체
안산 간판업체	안산 간판	안산 간판	간판
아산시 간판업체	아산 간판	아산 간판	간판업체
안성 간판업체	안성 간판	안성 간판	간판
안산시 간판업체	안산 간판	안산 간판	간판업체
안양 간판업체	안양 간판	안양 간판	간판
안성시 간판업체	안성 간판	안성 간판	간판업체
양주 간판업체	양주 간판	양주 간판	간판
안양시 간판업체	안양 간판	안양 간판	간판업체
양평 간판업체	양평 간판	양평 간판	간판
양주시 간판업체	양주 간판	양주 간판	간판업체
용인 간판업체	용인 간판	용인 간판	간판
양평군 간판업체	양평 간판	양평 간판	간판업체
원주 간판업체	원주 간판	원주 간판	간판
연천군 간판업체	연천 간판	연천 간판	간판업체
의왕 간판업체	의왕 간판	의왕 간판	간판
오산시 간판업체	오산 간판	오산 간판	간판업체
의정부 간판업체	의정부 간판	의정부 간판	간판
용인시 간판업체	용인 간판	용인 간판	간판업체
이천 간판업체	이천 간판	이천 간판	간판
원주시 간판업체	원주 간판	원주 간판	간판업체
인천  간판업체	인천  간판	인천  간판	간판
의왕시 간판업체	의왕 간판	의왕 간판	간판업체
춘천 간판업체	춘천 간판	춘천 간판	간판
의정부시 간판업체	의정부 간판	의정부 간판	간판업체
파주 간판업체	파주 간판	파주 간판	간판
이천시 간판업체	이천 간판	이천 간판	간판업체
평택 간판업체	평택 간판	평택 간판	간판
인천시 간판업체	인천 간판	인천 간판	간판업체
포천 간판업체	포천 간판	포천 간판	간판
제천시 간판업체	제천 간판	제천 간판	간판업체
하남 간판업체	하남 간판	하남 간판	간판
청평군 간판업체	청평 간판	청평 간판	간판업체
홍천 간판업체	홍천 간판	홍천 간판	간판
춘천시 간판업체	춘천 간판	춘천 간판	간판업체
화성 간판업체	화성 간판	화성 간판	간판
파주시 간판업체	파주 간판	파주 간판	간판업체
강남구 간판업체	강남구 간판	강남구 간판	간판
평택시 간판업체	평택 간판	평택 간판	간판업체
강동구 간판업체	강동구 간판	강동구 간판	간판
포천시 간판업체	포천 간판	포천 간판	간판업체
강북구 간판업체	강북구 간판	강북구 간판	간판
하남시 간판업체	하남 간판	하남 간판	간판업체
강서구 간판업체	강서구 간판	강서구 간판	간판
홍천군 간판업체	홍천 간판	홍천 간판	간판업체
강화도 간판업체	강화도 간판	강화도 간판	간판
화성시 간판업체	화성 간판	화성 간판	간판업체
관악구 간판업체	관악구 간판	관악구 간판	간판
광진구 간판업체	광진구 간판	광진구 간판	간판업체
구로구 간판업체	구로 간판	구로 간판	간판
금천구 간판업체	금천구 간판	금천구 간판	간판업체
동대문구 간판업체	동대문구 간판	동대문구 간판	간판
용산구 간판업체	용산구 간판	용산구 간판	간판업체
노원구 간판업체	노원구 간판	노원구 간판	간판
도봉구 간판업체	도봉구 간판	도봉구 간판	간판업체
동작구 간판업체	동작구 간판	동작구 간판	간판
마포구 간판업체	마포구 간판	마포구 간판	간판업체
부평구 간판업체	부평구 간판	부평구 간판	간판
서초구 간판업체	서초구 간판	서초구 간판	간판업체
성동구 간판업체	성동구 간판	성동구 간판	간판
성북구 간판업체	성북구 간판	성북구 간판	간판업체
송파구 간판업체	송파구 간판	송파구 간판	간판
양천구 간판업체	양천구 간판	양천구 간판	간판업체
영등포구 간판업체	영등포구 간판	영등포구 간판	간판
서대문구 간판업체	서대문구 간판	서대문구 간판	간판업체
은평구 간판업체	은평구 간판	은평구 간판	간판
종로구 간판업체	종로구 간판	종로구 간판	간판업체
중랑구 간판업체	중랑구 간판	중랑구 간판	간판
서울중구 간판업체	서울중구 간판	서울중구 간판	간판업체
인천 송도 간판업체	송도 간판	송도 간판	간판
남양주다산 간판업체	남양주 간판	남양주 간판	간판업체
분당 간판업체	분당 간판	분당 간판	간판
산본 간판업체	산본 간판	산본 간판	간판업체
위례 간판업체	위례 간판	위례 간판	간판
일산 간판업체	일산 간판	일산 간판	간판업체
판교 간판업체	판교 간판	성남 간판	간판
평촌 간판업체	평촌 간판	안양 간판	간판업체
검단 간판업체	검단 간판	검단 간판	간판
고덕 간판업체	고덕 간판	고덕 간판	간판업체
고촌 간판업체	고촌 간판	고촌 간판	간판
청라 간판업체	청라 간판	청라 간판	간판업체
파주 교하 간판업체	파주 간판	파주 간판	간판
파주 운정 간판업체	파주 간판	파주 간판	간판업체
수색 간판업체	수색 간판	수색 간판	간판
남양주 마석 간판업체	남양주 간판	남양주 간판	간판업체
남양주 화도 간판업체	남양주 간판	남양주 간판	간판
별내 간판업체	별내 간판	별내 간판	간판업체
송도 간판업체	송도 간판	송도 간판	간판
파주 야당 간판업체	파주 간판	파주 간판	간판업체
양주 옥정 간판업체	양주 간판	양주 간판	간판
왕십리 간판업체	왕십리 간판	왕십리 간판	간판업체
퇴계로 간판업체	퇴계로 간판	퇴계로 간판	간판
운정 간판업체	파주 간판	파주 간판	간판업체
잠실 간판업체	잠실 간판	잠실 간판	간판
정릉 간판업체	정릉 간판	정릉 간판	간판업체
을지로 간판업체	을지로 간판	을지로 간판	간판
홍대 간판업체	홍대 간판	홍대 간판	간판업체
광교 간판업체	광교 간판	광교 간판	간판
하남 미사 간판업체	하남 간판	하남 간판	간판업체
여주 간판업체	여주 간판	여주 간판	간판
노원 간판업체	노원 간판	노원 간판	간판업체
구로 간판업체	구로 간판	구로 간판	간판
수서 간판업체	수서 간판	수서 간판	간판업체
용인수지 간판업체	용인 간판	용인 간판	간판
동대문 간판업체	동대문 간판	동대문 간판	간판업체
마포 간판업체	마포 간판	마포 간판	간판
용산 간판업체	용산 간판	용산 간판	간판업체
서대문 간판업체	서대문 간판	서대문 간판	간판
송파 간판업체	송파 간판	송파 간판	간판업체
종로 간판업체	종로 간판	종로 간판	간판
영등포 간판업체	영등포 간판	영등포 간판	간판업체
부평 간판업체	부평 간판	부평 간판	간판
강남 간판업체	강남 간판	강남 간판	간판업체
서초 간판업체	서초 간판	서초구 간판	간판
검암 간판업체	검암 간판	인천 간판	간판업체
인천서구 간판업체	인천 간판	인천 간판	간판
병점 간판업체	병점 간판	화성 간판	간판업체
신도림 간판업체	신도림 간판	서울 간판	간판
신림 간판업체	신림 간판	서울 간판	간판업체
마곡 간판업체	마곡 간판	마곡 간판	간판
미추홀구 간판업체	미추홀구 간판	미추홀구 간판	간판업체
군포 간판업체	군포 간판	군포 간판	간판
문산 간판업체	문산 간판	파주 간판	간판업체
동탄 간판업체	동탄 간판	동탄 간판	간판
기흥 간판업체	기흥 간판	용인 간판	간판업체
신갈 간판업체	신갈 간판	용인 간판	간판
야탑 간판업체	야탑 간판	성남 간판	간판업체
죽전 간판업체	죽전 간판	용인 간판	간판
양재 간판업체	양재 간판	강남 간판	간판업체
상암동 간판업체	상암동 간판	마포 간판	간판
계양 간판업체	계양 간판	인천 간판	간판업체
상록구 간판업체	상록구 간판	안산 간판	간판
단원구 간판업체	단원구 간판	안산 간판	간판업체
영통 간판업체	영통 간판	수원 간판	간판
삼송 간판업체	삼송 간판	고양시 간판	간판업체
원당 간판업체	원당 간판	고양시 간판	간판
지축 간판업체	지축 간판	고양시 간판	간판업체
탄현 간판업체	탄현 간판	고양시 간판	간판
압구정 간판업체	압구정 간판	서울 간판	간판업체
신사 간판업체	신사 간판	서울 간판	간판
청담 간판업체	청담 간판	서울 간판	간판업체
반포 간판업체	반포 간판	서울 간판	간판
도곡동 간판업체	도곡동 간판	서울 간판	간판업체
봉천동 간판업체	봉천동 간판	서울 간판	간판
방배 간판업체	방배 간판	서울 간판	간판업체
이태원 간판업체	이태원 간판	서울 간판	간판
합정 간판업체	합정 간판	서울 간판	간판업체
신촌 간판업체	신촌 간판	서울 간판	간판
연신내 간판업체	연신내 간판	서울 간판	간판업체
천호 간판업체	천호동 간판	서울 간판	간판
암사 간판업체	암사 간판	서울 간판	간판업체
당산 간판업체	당산 간판	서울 간판	간판
불광동 간판업체	불광동 간판	서울 간판	간판업체
청계천 간판업체	청계천 간판	서울 간판	간판
돌출간판 제작	돌출간판제작	간판업체	간판
LED간판 제작	LED간판제작	LED간판제작	간판업체
입간판 제작	입간판제작	입간판제작	간판업체
병원간판 비용	병원간판비용	병원간판비용	간판업체
부동산간판 비용	부동산간판비용	부동산간판비용	간판
채널간판 비용	채널간판비용	채널간판비용	간판업체
LED실내간판	LED실내간판	LED실내간판	간판
옥외간판 제작	옥외간판제작	옥외간판제작	간판업체
큐브간판 비용	큐브간판비용	큐브간판비용	간판
포인트간판 가격	포인트간판가격	포인트간판가격	간판업체
스카시간판 종류	스카시간판종류	스카시간판종류	간판
아크릴간판 제작	아크릴간판제작	아크릴간판제작	간판업체
철제입간판	철제입간판	철제입간판	간판
카페간판 제작	카페간판제작	간판업체	간판업체
식당간판 디자인	식당간판 디자인	식당간판 디자인	간판
간판천갈이 비용	간판천갈이 비용	간판천갈이 비용	간판업체
간판시트지 제작	간판시트지 제작	간판시트지 제작	간판업체
갈바간판 비용	갈바간판 비용	갈바간판 비용	간판업체
포맥스간판 제작	포맥스간판 제작	포맥스간판 제작	간판
후렉스간판 비용	후렉스간판 비용	후렉스간판 비용	간판
LED돌출간판 설치	LED돌출간판 설치	LED돌출간판 설치	간판업체
철제간판 제작	철제간판 제작	철제간판 제작	간판
나무현판 제작	나무현판 제작	나무현판 제작	간판업체
학원간판 가격	학원간판 가격	학원간판 가격	간판
사무실현판 제작	사무실현판 제작	사무실현판 제작	간판업체
회사현판 제작	회사현판 제작	회사현판 제작	간판
LED전광판 설치	LED전광판 설치	LED전광판	간판업체
아크릴현판 제작	아크릴현판 제작	아크릴현판 제작	간판
실사출력 가격	실사출력 가격	간판	간판업체
회사명판 제작	회사명판 제작	회사명판 제작	간판
에어간판 가격	에어간판 가격	에어간판 가격	간판업체
메탈현판 제작	메탈현판 제작	메탈현판 제작	간판
LED입간판 제작	LED입간판 제작	LED입간판 제작	간판업체
사무실명판 제작	사무실명판 제작	사무실명판 제작	간판
미니간판 주문제작	미니간판 주문제작	미니간판 주문제작	간판업체
인천간판업체	인천간판업체	인천간판업체	간판
풍선간판 가격	풍선간판 가격	풍선간판 가격	간판업체
간판천갈이비용	간판천갈이비용	간판천갈이비용	간판업체
플렉스간판 가격	플렉스간판 가격	플렉스간판 가격	간판
미용실간판 디자인	미용실간판 디자인	미용실간판 디자인	간판업체
현판주문제작	현판주문제작	현판주문제작	간판
카페어닝 가격	카페어닝 가격	카페어닝 가격	간판업체
